border_size=1
usage=map

       Wo,       Wo,       Wo,       Wo,       Wo,       Wo,       Wo,       Wo,       Wo,       Wo,       Wo,       Wo,       Wo,       Wo,       Wo,       Wo,       Wo,       Wo,       Wo,       Wo,       Wo,       Wo
       Wo,       Wo,       Wo,       Wo,       Wo,       Wo,       Wo,       Wo,       Wo,       Wo,       Wo,       Wo,       Wo,       Wo,       Wo,       Wo,       Wo,       Wo,       Wo,       Wo,       Wo,       Wo
       Wo,       Wo,       Wo,       Wo,       Wo,       Wo,       Wo,       Wo,       Wo,       Wo,       Wo,       Wo,       Wo,       Wo,       Wo,       Wo,       Wo,       Wo,       Wo,       Wo,       Wo,       Wo
       Wo,       Wo,       Wo,       Wo,       Wo,       Wo,       Xu,       Xu,       Re,       Wo,       Wo,       Wo,       Wo,       Wo,       Wo,       Wo,       Wo,       Wo,       Wo,       Wo,       Wo,       Wo
       Wo,       Wo,       Wo,       Wo,       Wo,       Xu,       Re,       Re,       Ce,       Re,   Rr^Wyb,       Wo,       Wo,       Wo,       Wo,       Wo,       Wo,       Wo,       Wo,       Wo,       Wo,       Wo
       Wo,       Wo,       Wo,       Wo,       Wo,       Xu,       Re,       Ce,     1 Ke,       Ce,       Re,       Rr,   Rr^Wyb,       Wo,       Wo,       Wo,       Wo,       Wo,       Wo,       Wo,       Wo,       Wo
       Wo,       Wo,       Wo,       Wo,       Wo,       Xu,       Re,       Ce,       Ce,       Ce,       Re,       Re,       Re,       Rr,       Rr,       Wo,       Wo,       Wo,       Wo,       Wo,       Wo,       Wo
       Wo,       Wo,       Wo,       Wo,       Wo,       Wo,       Wo,       Re,   Rr^Wyb,       Re,       Re,       Re,       Xu,       Re,       Re,       Rr,       Rr,       Wo,       Wo,       Wo,       Wo,       Wo
       Wo,       Wo,       Wo,       Wo,       Wo,       Wo,       Wo,       Wo,   Ww^Bw|,       Rr,   Rr^Wyb,       Re,       Re,       Re,       Re,       Re,       Re,       Rr,       Xu,       Wo,       Wo,       Wo
       Wo,       Wo,       Wo,       Wo,       Xu,       Wo,       Wo,       Wo,   Ww^Bw|,       Wo,   Ww^Bw|,       Rr,       Rr,       Re,       Re,       Xu,       Re,       Re,       Xu,       Wo,       Wo,       Wo
       Wo,       Wo,       Xu,       Xu,       Re,       Rr,       Rr,       Wo,   Ww^Bw|,       Wo,   Ww^Bw|,       Wo,       Wo,       Rr,       Rr,       Re,       Re,       Re,       Xu,       Wo,       Wo,       Wo
       Wo,       Wo,       Xu,       Re,       Re,       Re,       Re,       Rr,   Rr^Wyb,       Wo,   Ww^Bw|,       Wo,       Wo,       Wo,       Wo,       Rr,       Xu,       Xu,       Wo,       Wo,       Wo,       Wo
       Wo,       Wo,       Xu,       Re,       Re,       Re,       Re,       Re,       Re,       Rr,   Rr^Wyb,       Wo,       Wo,       Wo,       Wo,       Wo,       Wo,       Wo,       Wo,       Wo,       Wo,       Wo
       Wo,       Wo,       Wo,       Rr,       Rr,       Re,       Re,       Xu,       Re,       Re,       Re,       Rr,       Xu,       Xu,       Xu,       Wo,       Wo,       Wo,       Wo,       Wo,       Wo,       Wo
       Wo,       Wo,       Wo,       Wo,       Wo,       Rr,   Rr^Wyb,       Re,       Re,       Re,       Xu,       Re,       Re,       Re,       Re,       Xu,       Xu,       Wo,       Wo,       Wo,       Wo,       Wo
       Wo,       Wo,       Wo,       Wo,       Wo,       Wo,       Wo,       Rr,   Rr^Wyb,       Re,       Re,       Re,       Ce,       Ce,       Ce,       Re,       Xu,       Wo,       Wo,       Wo,       Wo,       Wo
       Wo,       Wo,       Wo,       Wo,       Wo,       Wo,       Wo,       Wo,       Wo,       Rr,       Xu,       Re,       Ce,     2 Ke,       Ce,       Re,       Xu,       Wo,       Wo,       Wo,       Wo,       Wo
       Wo,       Wo,       Wo,       Wo,       Wo,       Wo,       Wo,       Wo,       Wo,       Wo,       Xu,       Re,       Re,       Ce,       Re,    Uu^Vu,       Xu,       Wo,       Wo,       Wo,       Wo,       Wo
       Wo,       Wo,       Wo,       Wo,       Wo,       Wo,       Wo,       Wo,       Wo,       Wo,       Wo,       Xu,       Xu,       Re,       Xu,       Xu,       Wo,       Wo,       Wo,       Wo,       Wo,       Wo
       Wo,       Wo,       Wo,       Wo,       Wo,       Wo,       Wo,       Wo,       Wo,       Wo,       Wo,       Wo,       Wo,       Xu,       Wo,       Wo,       Wo,       Wo,       Wo,       Wo,       Wo,       Wo
       Wo,       Wo,       Wo,       Wo,       Wo,       Wo,       Wo,       Wo,       Wo,       Wo,       Wo,       Wo,       Wo,       Wo,       Wo,       Wo,       Wo,       Wo,       Wo,       Wo,       Wo,       Wo
       Wo,       Wo,       Wo,       Wo,       Wo,       Wo,       Wo,       Wo,       Wo,       Wo,       Wo,       Wo,       Wo,       Wo,       Wo,       Wo,       Wo,       Wo,       Wo,       Wo,       Wo,       Wo
