border_size=1
usage=map

       Mm,       Mm,       Mm,       Mm,       Mm,       Mm,       Mm,       Mm,       Mm,       Mm,       Mm,       Mm,       Ha,       Mm,       Ha,       Mm,       Ha,       Mm,       Ha,       Mm,       Ha,       Ha,       Ha,       Mm,       Mm,       Mm,       Mm,       Ha,       Ha,       Aa,   Aa^Fpa,       Aa,       Aa,       Ai,       Ai,       Ai,       Ai,       Ai,       Ai
       Mm,       Mm,       Mm,       Mm,       Mm,       Mm,       Mm,       Mm,       Mm,       Mm,       Mm,       Mm,       Ha,       Mm,       Ha,       Mm,       Ha,       Mm,       Ha,       Mm,       Ha,       Ha,       Ha,       Mm,       Mm,       Mm,       Mm,       Ha,       Ha,       Aa,   Aa^Fpa,       Aa,       Aa,       Ai,       Ai,       Ai,       Ai,       Ai,       Ai
       Mm,       Mm,       Mm,       Mm,       Mm,       Mm,       Ha,       Mm,       Ha,       Ha,       Ha,       Ha,       Ha,       Ha,       Ha,       Ha,       Ha,       Mm,       Ha,       Ha,   Aa^Fpa,       Ha,       Ha,       Ha,       Ha,       Mm,       Ha,       Ha,   Aa^Fpa,   Aa^Fpa,   Aa^Fpa,       Aa,       Aa,       Ai,       Ww,       Ww,       Ai,       Ai,       Ai
       Mm,       Mm,       Mm,       Mm,       Mm,       Ha,       Ha,       Ha,   Aa^Fpa,       Ha,       Ha,       Ha,   Aa^Fpa,   Aa^Fpa,   Aa^Fpa,       Ha,       Ai,   Aa^Vha,   Aa^Fpa,   Aa^Fpa,       Ha,   Aa^Fpa,       Ha,       Ha,   Aa^Fpa,       Ha,       Ha,       Ha,       Aa,   Aa^Fpa,       Aa,       Aa,       Ai,       Ai,       Ai,       Ww,       Ai,       Wo,       Wo
       Mm,       Mm,       Mm,       Mm,       Ha,       Ha,       Ha,       Ha,       Aa,   Aa^Fpa,   Aa^Fpa,   Aa^Fpa,   Aa^Fpa,   Aa^Fpa,   Aa^Fpa,       Ai,       Ai,       Aa,       Aa,       Aa,       Aa,       Ha,       Ha,       Ha,       Ha,       Aa,       Aa,       Aa,   Aa^Fpa,       Aa,       Ai,       Ai,       Ai,       Wo,       Ai,       Ai,       Wo,       Wo,       Wo
       Mm,       Mm,       Mm,       Mm,       Ha,       Ha,       Ha,       Ha,       Aa,       Aa,       Aa,       Aa,       Aa,       Aa,       Aa,       Ai,       Ai,       Aa,       Aa,   Aa^Fpa,       Aa,       Aa,       Aa,       Aa,       Aa,       Aa,   Aa^Vha,   Aa^Fpa,   Aa^Fpa,       Aa,       Ai,       Ai,       Ww,       Wo,       Ww,       Ai,       Wo,       Wo,       Wo
       Mm,       Mm,       Mm,       Mm,       Ha,       Ha,       Ha,       Ha,   Aa^Fpa,       Aa,       Ha,       Aa,       Ha,       Aa,       Ai,       Ai,   Aa^Fpa,       Aa,       Re,   Aa^Fpa,       Re,       Aa,       Aa,       Aa,   Aa^Fpa,       Aa,       Aa,       Aa,       Aa,       Ai,       Ai,       Ai,       Ai,       Ai,       Ai,       Wo,       Wo,       Wo,       Wo
       Mm,       Mm,       Mm,       Mm,       Ha,       Ha,       Ha,       Ha,   Aa^Fpa,   Aa^Vha,       Ha,       Ha,       Uu,       Ai,       Ai,       Ai,       Aa,   Aa^Fpa,       Ha,       Re,   Aa^Fpa,       Re,   Aa^Fpa,   Aa^Fpa,   Aa^Fpa,       Aa,       Ha,       Ha,   Aa^Fpa,       Aa,       Aa,       Ai,       Ww,       Ww,       Wo,       Ai,       Wo,       Wo,       Wo
       Mm,       Mm,       Mm,       Mm,       Ha,       Ha,       Ha,       Ha,   Aa^Fpa,   Aa^Fpa,       Uu,       Uu,     2 Kud,       Ai,       Uu,       Aa,   Aa^Fpa,       Aa,       Aa,       Ha,       Ha,       Aa,       Aa,   Aa^Vha,       Aa,       Aa,       Ha,   Aa^Fpa,       Ha,   Aa^Fpa,       Aa,       Aa,       Ai,       Wo,       Ww,       Ai,       Wo,       Wo,       Wo
       Mm,       Mm,       Ha,       Ha,       Ha,       Ha,       Aa,       Ha,       Aa,       Aa,       Ai,      Cud,      Cud,      Cud,       Uu,   Aa^Fpa,   Aa^Fpa,       Aa,       Aa,       Aa,       Aa,       Ha,       Aa,       Aa,       Aa,       Aa,       Aa,       Ha,       Ha,   Aa^Fpa,       Aa,       Aa,       Ai,       Ai,       Ai,       Ai,       Ai,       Wo,       Wo
       Ha,       Ha,       Ha,       Ha,       Ha,       Ha,   Aa^Fpa,       Aa,       Aa,       Ai,       Ai,       Uu,       Uu,       Uu,   Aa^Vha,       Aa,       Re,       Aa,       Aa,       Aa,       Aa,       Ha,       Aa,       Aa,   Aa^Fpa,       Re,       Re,       Aa,   Aa^Fpa,   Aa^Fpa,       Aa,       Aa,       Ai,       Ww,       Ai,       Wo,       Ai,       Wo,       Wo
       Ha,       Ha,       Ha,       Ha,       Ha,       Ha,       Ha,   Aa^Fpa,       Aa,       Ai,       Aa,       Aa,       Aa,       Ha,       Ha,       Aa,       Ha,       Re,   Aa^Fpa,   Aa^Fpa,   Aa^Fpa,       Aa,       Ha,   Aa^Fpa,   Aa^Fpa,       Ai,       Ai,       Aa,       Gg,       Aa,       Aa,       Aa,       Aa,       Ai,       Ai,       Ww,       Ai,       Ai,       Ai
       Ha,       Ha,       Aa,       Ha,       Aa,       Aa,       Ha,       Ha,       Ha,       Ha,       Ha,       Aa,       Aa,       Aa,       Aa,       Ha,       Aa,       Aa,       Aa,   Aa^Fpa,       Aa,       Aa,   Aa^Vha,   Aa^Fpa,       Ha,       Ai,       Ai,       Ai,       Gg,       Gg,   Aa^Fpa,   Aa^Vha,   Aa^Fpa,       Aa,       Aa,       Ai,       Ai,       Ai,       Ai
   Aa^Fpa,   Aa^Fpa,   Aa^Fpa,       Aa,       Aa,       Aa,       Aa,   Aa^Vha,       Aa,       Ha,       Aa,       Aa,   Aa^Fpa,   Aa^Fpa,       Aa,       Aa,   Aa^Fpa,       Aa,       Re,       Aa,       Aa,       Aa,       Ha,       Ha,       Aa,       Ai,       Ai,       Ai,       Aa,       Aa,   Aa^Fpa,   Aa^Fpa,       Ha,   Aa^Fpa,       Aa,       Ai,       Ai,       Wo,       Wo
       Aa,       Aa,   Aa^Fpa,   Aa^Fpa,       Aa,       Aa,       Ai,       Ai,       Ww,       Aa,       Aa,   Aa^Fpa,   Aa^Fpa,       Aa,       Aa,       Aa,   Aa^Fpa,   Aa^Fpa,       Aa,       Re,       Aa,       Aa,       Re,       Aa,       Aa,       Aa,       Aa,   Aa^Fpa,       Ha,       Ha,   Aa^Fpa,       Ha,       Aa,       Aa,       Aa,       Ai,       Wo,       Wo,       Wo
   Aa^Fpa,   Aa^Fpa,       Ai,       Aa,       Ai,       Ai,       Aa,       Ww,       Ww,       Ai,       Aa,   Aa^Fpa,   Aa^Fpa,   Aa^Fpa,   Aa^Fpa,       Aa,       Ai,       Aa,       Aa,       Re,   Aa^Fpa,   Aa^Fpa,   Aa^Fpa,   Aa^Fpa,   Aa^Fpa,       Aa,       Re,       Ha,       Aa,       Ha,       Ha,       Ha,       Aa,       Aa,       Gg,       Ww,       Ai,       Wo,       Wo
       Ai,       Ai,       Ai,       Ai,       Ai,       Aa,       Aa,       Aa,       Gg,       Aa,   Aa^Fpa,       Aa,       Aa,   Aa^Fpa,       Aa,       Ai,       Ai,       Aa,       Aa,       Aa,       Aa,       Aa,       Ha,   Aa^Fpa,       Aa,       Re,       Aa,       Re,       Aa,       Aa,       Aa,       Aa,       Aa,   Aa^Fpa,   Aa^Fpa,       Ww,       Ww,       Wo,       Wo
       Ai,       Ai,       Ww,       Ai,       Ai,   Aa^Fpa,   Aa^Fpa,       Gg,       Gg,   Aa^Fpa,   Aa^Fpa,   Aa^Fpa,   Aa^Vha,       Ha,       Aa,       Ai,       Aa,       Aa,       Ha,       Aa,       Ha,   Aa^Vha,       Ha,       Aa,       Aa,   Aa^Fpa,       Gg,       Aa,   Aa^Fpa,   Aa^Fpa,       Ce,       Ce,       Ce,   Aa^Fpa,   Aa^Vha,       Ww,       Ww,       Ai,       Ai
       Ai,       Ai,       Ww,       Ai,       Ai,       Aa,       Aa,       Aa,       Aa,   Aa^Fpa,   Aa^Fpa,       Ha,       Ha,       Aa,       Ha,       Aa,       Ha,       Aa,       Aa,       Ha,       Aa,       Ha,       Aa,       Aa,       Gg,   Aa^Fpa,       Aa,       Gg,       Ai,       Aa,       Ai,     1 Ke,       Aa,   Aa^Fpa,       Gg,       Gg,       Ww,       Ai,       Ai
       Ai,       Ai,       Wo,       Ai,       Ai,       Ai,       Ai,       Ai,       Aa,       Aa,       Aa,   Aa^Fpa,       Aa,       Ha,       Aa,       Ha,       Aa,       Aa,       Ai,       Aa,       Ai,       Aa,       Aa,       Gg,       Gg,       Gg,       Ai,       Ai,       Ai,       Ai,       Ai,       Gg,       Ww,       Aa,       Ww,       Ww,       Ww,       Wo,       Wo
       Ai,       Ai,       Wo,       Ai,       Ai,       Ai,       Ai,       Ai,       Ai,       Ai,       Ai,       Ai,       Ai,       Ai,       Ai,       Aa,       Ai,       Ai,       Ww,       Ai,       Ai,       Ai,       Ai,       Ai,       Ai,       Ai,       Ai,       Ai,       Ww,       Ww,       Ai,       Ww,       Ww,       Ww,       Ww,       Wo,       Wo,       Ai,       Ai
       Wo,       Wo,       Wo,       Wo,       Wo,       Ai,       Ai,       Ai,       Ai,       Ai,       Ai,       Ai,       Ww,       Ai,       Ai,       Ai,       Ai,       Ai,       Ai,       Ww,       Ai,       Ww,       Ww,       Ww,       Ai,       Ai,       Ww,       Ww,       Ai,       Wo,       Wo,       Wo,       Ai,       Wo,       Ai,       Wo,       Wo,       Wo,       Wo
       Wo,       Wo,       Wo,       Wo,       Wo,       Ai,       Ai,       Ai,       Ai,       Ai,       Ai,       Ai,       Ww,       Ai,       Ai,       Ai,       Ai,       Ai,       Ai,       Ww,       Ai,       Ww,       Ww,       Ww,       Ai,       Ai,       Ww,       Ww,       Ai,       Wo,       Wo,       Wo,       Ai,       Wo,       Ai,       Wo,       Wo,       Wo,       Wo
