border_size=1
usage=map

       Wo,       Wo,       Wo,       Wo,       Wo,       Wo,       Wo,       Wo,       Wo,       Wo,       Wo,       Wo,       Wo,       Wo,       Wo,       Wo,       Wo,       Wo,       Wo,       Wo,       Wo,       Wo,       Wo
       Wo,       Wo,       Wo,       Wo,       Wo,       Wo,       Wo,       Wo,       Wo,       Wo,       Wo,       Wo,       Wo,       Wo,       Wo,       Wo,       Wo,       Wo,       Wo,       Wo,       Wo,       Wo,       Wo
       Wo,       Wo,       Wo,       Wo,       Wo,       Wo,       Ww,       Ww,       Ww,       Ww,       Ww,       Wo,   Ww^Bw|,       Wo,       Ww,       Wo,       Ww,       Ww,       Ww,       Wo,       Wo,       Wo,       Wo
       Wo,       Wo,       Wo,       Wo,       Ww,       Ww,       Dd,       Dd,       Dd,       Dd,       Dd,       Ww,       Dd,       Ww,       Dd,       Ww,       Dd,       Dd,       Dd,       Ww,       Ww,       Wo,       Wo
       Wo,       Wo,       Ww,       Ww,       Dd,       Dd,   Gs^Vht,       Gs,       Gs,       Hd,    Gs^Ft,       Dd,       Gs,       Dd,       Gs,       Dd,       Hd,    Gs^Ft,    Gs^Ft,       Dd,       Ww,       Wo,       Wo
       Wo,       Wo,       Ww,       Dd,    Gs^Ft,    Gs^Ft,       Hh,       Hh,       Hh,    Gs^Ft,       Ch,       Ch,       Ch,       Gs,       Gs,       Gs,       Gs,    Gs^Ft,       Dd,       Dd,       Ww,       Wo,       Wo
       Wo,       Wo,       Ww,       Dd,       Dd,    Gs^Ft,       Gs,       Gs,       Gs,       Gs,       Ch,     2 Kh,       Ch,       Gs,       Gs,       Hh,   Gs^Vht,       Dd,       Ww,       Ww,       Wo,       Wo,       Wo
       Wo,       Wo,       Wo,       Ww,       Ww,       Dd,       Gs,       Gs,       Gs,       Gs,       Gs,       Ch,       Gs,    Gs^Ft,       Hh,       Hh,    Gs^Ft,       Dd,       Dd,       Ww,       Wo,       Wo,       Wo
       Wo,       Wo,       Wo,       Wo,       Ww,       Dd,   Gs^Vht,       Gs,       Hh,       Gs,       Gs,       Gs,       Gs,    Gs^Ft,    Gs^Ft,       Hh,    Gs^Ft,    Gs^Ft,       Dd,       Ww,       Wo,       Wo,       Wo
       Wo,       Wo,       Wo,       Wo,       Ww,       Dd,       Gs,       Gs,       Gs,       Hh,       Gs,       Gs,       Gs,       Gs,       Hh,       Gs,       Gs,       Dd,       Ww,       Ww,       Wo,       Wo,       Wo
       Wo,       Wo,       Wo,       Wo,       Ww,       Dd,       Gs,    Gs^Ft,    Gs^Ft,       Gs,    Gs^Ft,       Gs,       Gs,       Gs,       Hh,       Gs,       Dd,       Dd,       Ww,       Wo,       Wo,       Wo,       Wo
       Wo,       Wo,       Ww,       Ww,       Dd,       Dd,       Gs,       Gs,       Gs,    Gs^Ft,    Gs^Ft,       Hh,       Hh,       Gs,    Gs^Ft,       Gs,       Dd,       Ww,       Wo,       Wo,       Wo,       Wo,       Wo
       Wo,       Wo,       Ww,       Dd,       Gs,       Gs,       Hh,       Gs,       Hh,       Hh,       Gs,   Gs^Vht,       Gs,    Gs^Ft,       Hh,   Gs^Vht,       Dd,       Ww,       Wo,       Wo,       Wo,       Wo,       Wo
       Wo,       Wo,       Ww,       Dd,   Gs^Vht,       Gs,       Gs,       Hh,       Gs,       Gs,       Gs,       Gs,       Gs,    Gs^Ft,       Gs,       Gs,       Dd,       Ww,       Wo,       Wo,       Wo,       Wo,       Wo
       Wo,       Wo,       Ww,       Dd,    Gs^Ft,    Gs^Ft,       Gs,    Gs^Ft,    Gs^Ft,    Gs^Ft,       Gs,       Gs,       Gs,    Gs^Ft,       Gs,       Gs,       Dd,       Ww,       Wo,       Wo,       Wo,       Wo,       Wo
       Wo,       Wo,       Ww,       Dd,       Dd,    Gs^Ft,    Gs^Ft,       Gs,       Hh,       Hh,       Gs,       Gs,       Gs,       Hh,       Hh,       Gs,       Dd,       Ww,       Wo,       Wo,       Wo,       Wo,       Wo
       Wo,       Wo,       Wo,       Ww,       Ww,       Dd,   Gs^Vht,       Hh,       Gs,       Gs,       Ce,       Gs,       Gs,       Gs,    Gs^Ft,       Gs,       Dd,       Ww,       Ww,       Wo,       Wo,       Wo,       Wo
       Wo,       Wo,       Wo,       Ww,       Ww,       Dd,       Hd,       Gs,       Gs,       Ce,     1 Ke,       Ce,       Gs,       Gs,       Gs,    Gs^Ft,       Gs,       Dd,       Ww,       Wo,       Wo,       Wo,       Wo
       Wo,       Wo,       Wo,       Wo,       Ww,       Dd,       Dd,       Hd,    Gs^Ft,       Gs,       Gs,       Hd,    Gs^Ft,       Hd,   Gs^Vht,       Gs,       Dd,       Dd,       Ww,       Wo,       Wo,       Wo,       Wo
       Wo,       Wo,       Wo,       Wo,       Wo,       Ww,       Dd,       Hd,       Md,    Gs^Ft,    Gs^Ft,    Gs^Ft,    Gs^Ft,       Md,       Md,       Dd,       Ww,       Ww,       Wo,       Wo,       Wo,       Wo,       Wo
       Wo,       Wo,       Wo,       Wo,       Wo,       Ww,       Dd,       Md,       Md,    Gs^Ft,    Gs^Ft,    Gs^Ft,    Gs^Ft,       Md,       Md,       Dd,       Ww,       Wo,       Wo,       Wo,       Wo,       Wo,       Wo
       Wo,       Wo,       Wo,       Wo,       Wo,       Ww,       Dd,       Md,       Md,    Gs^Ft,    Gs^Ft,    Gs^Ft,    Gs^Ft,       Md,       Md,       Dd,       Ww,       Wo,       Wo,       Wo,       Wo,       Wo,       Wo
