border_size=1
usage=map

       Wo,       Wo,       Wo,       Wo,       Wo,       Wo,       Wo,       Wo,       Wo,       Wo,       Wo,       Wo,       Wo,       Wo,       Wo,       Wo,       Ww,       Ww,       Ww,       Ww,       Ww,       Wo,       Wo,       Wo,       Wo,       Wo,    Ww,       Wo,       Wo,       Wo
       Wo,       Wo,       Wo,       Wo,       Wo,       Wo,       Wo,       Wo,       Wo,       Wo,       Wo,       Wo,       Wo,       Wo,       Wo,       Wo,       Ww,       Ww,       Ww,       Ww,       Ww,       Wo,       Wo,       Wo,       Wo,       Wo,    Ww^Vm,       Wo,       Wo,       Wo
    Ww,    Ww^Vm,       Wo,       Wo,       Wo,       Wo,       Wo,       Wo,       Ww,       Wo,       Ww,       Ww,       Ww,       Ww,       Ww,       Ww,       Ds,       Ds,       Gg,       Ww,       Ww,       Ww,       Ww,       Wo,       Wo,       Wo,       Wo,       Wo,       Wo,       Wo
       Wo,       Wo,       Wo,       Wo,       Wo,       Wo,       Ww,       Ww,       Ds,       Ww,       Ww,       Ww,       Ds,       Ww,       Ds,       Ww,       Gg,       Gg,       Hh,       Gg,       Gg,       Ds,       Ds,       Ww,       Ww,       Wo,       Wo,       Wo,       Wo,       Wo
       Wo,       Wo,       Wo,       Wo,       Ww,       Ww,       Ds,       Ds,       Gg,       Ds,       Gg,       Gg,       Gg,       Gg,       Gg,    Gg^Vh,       Gg,       Hh,       Mm,       Hh,       Hh,       Gg,       Gg,       Ds,       Ww,       Ww,       Ww,       Wo,       Wo,       Wo
       Wo,       Wo,       Wo,       Ww,       Ww,       Ww,       Gg,       Gg,       Hh,       Gg,       Gg,       Gg,       Gg,       Hh,       Gg,       Hh,       Hh,       Hh,       Mm,       Mm,       Hh,    Gg^Vh,       Hh,       Gg,       Gg,       Ww,       Ww,       Wo,       Wo,       Wo
       Wo,       Wo,       Wo,       Ww,       Ww,       Gg,       Gg,       Hh,       Hh,       Hh,       Mm,       Gg,       Hh,       Gg,       Gg,       Mm,       Mm,       Hh,       Mm,       Hh,       Mm,       Hh,       Mm,       Hh,       Gg,       Ww,       Ww,       Wo,       Wo,       Wo
       Wo,       Wo,       Wo,       Ww,       Ww,       Gg,       Gg,       Hh,       Hh,       Mm,       Hh,       Mm,       Mm,       Mm,       Mm,       Mm,       Mm,       Mm,       Mm,       Mm,       Mm,       Mm,       Hh,       Hh,       Gg,       Ds,       Ww,       Wo,       Wo,       Wo
       Wo,       Wo,       Wo,       Ww,       Ww,       Ww,       Ww,       Gg,       Gg,       Hh,       Hh,       Hh,       Mm,       Mm,       Ch,       Ch,       Ch,       Mm,       Mm,       Mm,       Mm,       Mm,       Hh,    Gg^Vh,       Ds,       Ds,       Ww,       Wo,       Wo,       Wo
       Wo,       Wo,       Wo,       Wo,       Wo,       Ww,       Ww,       Gg,       Gg,    Gg^Vh,       Hh,       Mm,       Mm,       Mm,       Ch,     2 Kh,       Ch,       Hh,       Hh,       Mm,       Mm,       Mm,       Hh,       Gg,       Ds,       Ww,       Ww,       Wo,       Wo,       Wo
       Wo,       Wo,       Wo,       Wo,       Ww,       Ww,       Ds,       Gg,       Gg,       Gg,       Hh,       Mm,       Mm,       Mm,       Mm,       Ch,       Ww,       Ww,       Hh,       Mm,       Mm,       Mm,       Hh,       Gg,       Gg,       Ds,       Ww,       Wo,       Wo,       Wo
       Wo,       Wo,       Ww,       Ww,       Ds,       Ds,       Gg,       Gg,       Gg,       Gg,       Hh,       Mm,       Mm,       Mm,       Mm,       Mm,       Hh,       Ww,       Hh,       Mm,       Hh,       Hh,       Mm,       Gg,       Gg,       Ds,       Ww,       Wo,       Wo,       Wo
       Wo,       Wo,       Ww,       Ds,       Ds,       Ds,       Gg,    Gs^Fp,    Gs^Fp,    Gs^Fp,    Gs^Fp,       Hh,       Hh,       Mm,       Mm,       Mm,       Hh,       Ww,       Hh,       Mm,       Hh,       Hh,       Hh,       Hh,       Gg,       Ds,       Ww,       Wo,       Wo,       Wo
       Wo,       Wo,       Ww,       Ds,       Ds,       Gg,       Gg,    Gs^Fp,    Gs^Fp,    Gs^Fp,       Mm,       Hh,    Gg^Vh,       Hh,       Hh,       Mm,       Hh,       Ww,       Gg,       Hh,    Gg^Vh,       Gg,       Gg,       Hh,       Hh,       Ds,       Ww,       Wo,       Wo,       Wo
       Wo,       Wo,       Ww,       Ds,       Ds,       Gg,    Gs^Fp,    Gs^Fp,    Gs^Fp,       Hh,       Hh,    Gs^Fp,    Gs^Fp,       Gg,       Gg,       Hh,       Gg,       Ww,       Ww,       Gg,       Gg,       Gg,       Gg,       Hh,       Hh,       Ds,       Ww,       Ww,       Wo,       Wo
       Wo,       Wo,       Ww,       Ds,       Ds,       Ds,    Gs^Fp,    Gg^Vh,    Gs^Fp,    Gs^Fp,       Mm,       Hh,    Gs^Fp,       Gg,    Gs^Fp,       Mm,       Hh,       Ww,       Ww,       Gg,       Gg,       Gg,       Gg,       Hh,       Gg,    Gg^Vh,       Ww,       Ww,       Wo,       Wo
       Wo,       Wo,       Ww,       Ds,       Ds,       Ds,       Gg,    Gs^Fp,    Gs^Fp,       Hh,       Hh,       Hh,    Gs^Fp,    Gs^Fp,    Gs^Fp,       Hh,       Mm,       Gg,       Ww,       Ww,       Gg,       Gg,       Gg,       Gg,       Gg,       Gg,       Ds,       Ww,       Wo,       Wo
       Wo,       Wo,       Ww,       Ww,       Ds,       Ds,       Ds,    Gs^Fp,    Gs^Fp,    Gs^Fp,    Gs^Fp,       Mm,       Hh,    Gs^Fp,    Gs^Fp,    Gs^Fp,       Hh,       Gg,       Gg,       Ww,       Ww,       Gg,       Ce,       Ce,       Ce,       Gg,       Ds,       Ww,       Wo,       Wo
       Wo,       Wo,       Ww,       Ds,       Ds,       Ds,       Ds,       Ds,    Gs^Fp,       Gg,    Gs^Fp,       Hh,    Gs^Fp,    Gs^Fp,    Gs^Fp,       Gg,    Gs^Fp,    Gs^Fp,       Gg,       Ww,       Ww,       Gg,       Ce,     1 Ke,       Ce,       Gg,       Ds,       Ww,       Wo,       Wo
       Wo,       Wo,       Ww,       Ds,       Ds,       Ds,       Ds,       Ds,       Gg,       Gg,    Gs^Fp,    Gs^Fp,    Gs^Fp,    Gs^Fp,    Gs^Fp,    Gg^Vh,    Gs^Fp,       Gg,       Gg,       Ww,       Ww,       Gg,       Gg,       Ce,       Gg,       Gg,       Ds,       Ww,       Wo,       Wo
       Wo,       Wo,       Wo,       Ww,       Ww,       Ww,       Ds,       Ds,       Ds,       Ds,    Gg^Vh,    Gs^Fp,    Gs^Fp,    Gs^Fp,    Gs^Fp,    Gs^Fp,       Gg,       Gg,       Gg,       Gg,       Ww,       Ww,       Gg,       Gg,       Gg,       Gg,       Ds,       Ww,       Wo,       Wo
       Wo,       Wo,       Wo,       Wo,       Wo,       Ww,       Ww,       Ds,       Ds,       Ds,       Gg,    Gs^Fp,    Gs^Fp,    Gs^Fp,    Gs^Fp,    Gs^Fp,       Gg,    Gs^Fp,       Gg,       Gg,       Gg,       Ww,       Ww,    Gg^Vh,       Gg,    Gg^Vh,       Ds,       Ww,       Wo,       Wo
       Wo,       Wo,       Wo,       Wo,       Wo,       Wo,       Wo,       Ww,       Ww,       Ds,       Ds,    Gs^Fp,    Gs^Fp,    Gs^Fp,    Gs^Fp,       Gg,    Gs^Fp,    Gs^Fp,       Gg,       Hh,       Gg,       Ww,       Ww,       Ww,       Ww,       Ww,       Ww,       Ww,       Wo,       Wo
       Wo,       Wo,       Wo,       Wo,       Wo,       Wo,       Wo,       Wo,       Ww,       Ds,       Ds,       Ds,       Ds,       Ds,       Gg,       Gg,       Gg,       Hh,       Mm,       Mm,       Hh,    Gg^Vh,       Gg,       Ww,       Ww,    Gg^Vh,       Ww,       Wo,       Wo,       Wo
       Wo,       Wo,       Wo,       Wo,       Wo,       Wo,       Wo,       Wo,       Wo,       Ww,       Ww,       Ds,       Ds,       Ds,       Gg,       Gg,       Gg,       Hh,       Hh,       Mm,       Hh,       Gg,       Gg,    Gg^Vh,       Ww,       Gg,       Wo,       Wo,       Wo,       Wo
       Wo,       Wo,       Wo,       Wo,       Wo,       Wo,       Wo,       Wo,       Wo,       Wo,       Wo,       Ww,       Ww,       Ds,       Ds,       Gg,       Ds,       Gg,       Gg,       Gg,       Gg,       Gg,       Ds,       Ds,       Ww,       Ww,       Wo,       Wo,       Wo,       Wo
       Wo,       Wo,       Wo,       Wo,       Wo,       Wo,       Wo,       Wo,       Wo,       Wo,       Wo,       Wo,       Wo,       Ww,       Ww,       Ds,       Ds,       Ds,       Ds,       Ds,       Ds,       Ds,       Ww,       Ww,       Wo,       Wo,       Wo,       Wo,       Wo,       Wo
       Wo,       Wo,       Wo,       Wo,       Wo,    Ww^Vm,       Wo,       Wo,       Wo,       Wo,       Wo,       Wo,       Wo,       Wo,       Wo,       Ww,       Ww,       Ds,       Ww,       Ww,       Ww,       Ww,       Wo,       Wo,       Wo,       Wo,       Wo,       Wo,       Wo,       Wo
       Wo,       Wo,       Wo,       Wo,       Wo,       Wo,       Wo,       Wo,       Wo,       Wo,       Wo,       Wo,       Wo,       Wo,       Wo,       Wo,       Wo,       Ww,       Wo,       Wo,       Wo,       Wo,       Wo,       Wo,       Wo,       Wo,       Wo,    Ww^Vm,       Wo,       Wo
       Wo,       Wo,       Wo,       Wo,       Wo,       Wo,       Wo,       Wo,       Wo,       Wo,       Wo,       Wo,       Wo,       Wo,       Wo,       Wo,       Wo,       Ww,       Wo,       Wo,       Wo,       Wo,       Wo,       Wo,       Wo,       Wo,       Wo,    Ww,       Wo,       Wo
